[
    [18,   18,   18,   18,   18,   18,   18,   18,   18,   18,   18,   18,   18,   18,   18,   18,   18,   18,   18,   18],
    [18,   1,    1,    1,    1,    1,    1,    1,    -3,    1,    1,    18,    1,    1,    1,    1,    1,    1,    1,    18],
    [18,   1,    18,   18,   18,   1,    18,   18,   18,   18,    1,    18,    1,    18,    18,    18,    1,    1,    1,    18],
    [18,   1,    18,   1,    18,    1,    18,    1,    1,    18,    1,    18,    1,    18,    1,    18,    1,    -2,    1,    18],
    [18,   1,    18,   1,    18,    1,    18,    1,    1,    18,    1,    18,    1,    18,    1,    18,    1,    1,    1,    18],
    [18,   1,    18,   1,    18,    1,    18,    1,    1,    18,    1,    18,    1,    18,    1,    18,    1,    1,    1,    18],
    [18,   18,   18,   1,    18,    1,    18,    1,    1,    18,    1,    18,    1,    18,    1,    18,    1,    1,    1,    18],
    [18,   1,    1,    1,    18,    1,    1,    1,    1,    18,    1,    18,    1,    18,    1,    18,    1,    18,    1,    18],
    [18,   1,    1,    1,    18,    1,    18,    18,    18,    18,    1,    18,    1,    1,    1,    18,    1,    18,    1,    18],
    [18,   1,    1,    1,    18,    1,    18,    "1_5-Muck Forest",    "A_7",    18,    1,    18,    1,    1,    1,    18,    1,    18,    1,    18],
    [18,   1,    1,    1,    18,    1,    18,    1,    1,    18,    1,    18,    1,    "1_4-Windswept Fairy Valley",    "A_5",    18,    1,    18,    1,    18],
    [18,   1,    18,    18,    18,    1,    18,    1,    1,    18,    1,    18,    18,   18,   18,   18,   1,    18,   18,    18],
    [18,   1,    1,    1,    1,    1,    1,    1,    1,    18,    1,    1,    -1,    1,    "1_3",  1,    1,    1,    1,    18],
    [18,   1,    1,    1,    1,    1,    1,    1,    1,    18,    1,    1,    1,    1,    1,    1,    1,    1,    1,    18],
    [18,   -6,    1,    -6,    18,    18,    18,    18,    18,    18,   18,   1,    18,   18,   18,   18,   18,   18,    1,    18],
    [18,   1,    1,    1,    18,    1,    1,    1,    1,    18,    1,    1,    18,    1,    1,    1,    1,    18,    1,    18],
    [18,   1,    -4,    1,    18,    1,    -2,    1,    1,    18,    1,    1,    18,    1,    1,    1,    1,    18,    1,    18],
    [18,   1,    1,    1,    18,    1,    1,    1,    1,    18,    1,    1,    18,    1,    1,    1,    -1,    18,    1,    18],
    [18,   "1_2",    1,    "1_2",    18,    1,    1,    1,    1,    1,    1,    1,    1,    1,    1,    1,    1,    18,    "D",  18],
    [18,   18,   18,   18,   18,   18,   18,   18,   18,   18,   18,   18,   18,   18,   18,   18,   18,   18,   18,   18]
]