[
    [2,   2,   2,   2,   2,   2,   2,   2,   2,   2,   2,   2,   2,   2,   2,   2,   2,   2,   2,   2],
    [2,   1,   1,   1,   1,   1,   1,   1,   1,   1,   1,   1,   -2,  1,   1,   1,   1,   1,  1,   2],
    [2,   1,   1,   1,  1,   1,   2,   2,   2,   2,   1,   1,   1,   1,   1,   1,   1,    1,   1,  2],
    [2,   1,   2,   2,   1,   1,   2,   "1_5-City of Axagon","A_3",2, 2,   2,   1,   1,   1,   2,   1,   1,   1,   2],
    [2,   1,   1,   2,   1,   1,   2,   1,   1,   1,   1,   2,   1,   1,   1,   2,   1,   1,   1,   2],
    [2,   1,   2,   2,   1,   1,   2,   1,   -12,   1,   1,   2,   1,   1,   1,   2,   1,   1,   1,   2],
    [2,   1,   1,   2,   1,   1,   2,   1,   1,   1,   1,   2,   1,   2,   2,   2,   2,   1,   1,   2],
    [2,   1,   2,   2,   2,   2,   2,   1,   2,   2,   2,   2,   1,   2,   1,   1,   2,   1,   1,   2],
    [2,   1,   1,   1,   1,   1,   1,   1,   2,   1,   1,   1,   1,   2,   1,   1,   2,   2,   1,   2],
    [2,   1,   2,   1,   1,   1,   1,   1,   2,   -3,  1,   1,   1,   2,   1,   1,   -2,  2,   1,   2],
    [2,   2,   2,   2,   2,   2,   1,   1,   2,   2,   2,   2,   1,   2,   1,   1,   1,   2,   1,   2],
    [2,   1,   1,   1,   1,   2,   1,   1,   1,   1,   1,   2,   2,   2,   1,   1,   1,   1,   1,   2],
    [2,   1,   1,   1,   1,   2,   1,   1,   1,   1,   -2,  1,   1,   1,   2,   2,   2,   2,   1,   2],
    [2,   1,   1,   1,   1,   2,   1,   2,   2,   2,   2,   1,   2,   2,   2,   1,   1,   2,   1,   2],
    [2,   1,   2,   2,   2,   2,   1,   2,   1,   2,   1,   1,   1,   1,   2,   1,   1,   2,   1,   2],
    [2,   1,   -6,  1,   1,   2,   1,   2,   1,   2,   1,   1,   1,   1,   1,   1,   2,   2,   1,   2],
    [2,   1,   1,   -7,  1,   2,   1,   2,   1,   2,   1,   1,   "1_2",1,  1,   1,   2,   1,   1,   2],
    [2,   "1_5-Windswept Fairy Valley",1,  1,   1,   2,   1,   2,   1,   1,   1,   1,   1,   1,   1,   1,   2,   1,   "D", 2],
    [2,   "A_5",1, -6,  1,   1,   1,   2,   1,   1,   1,   1,   1,   1,   "1_6",1,  2,   1,   1,   2],
    [2,   2,   2,   2,   2,   2,   2,   2,   2,   2,   2,   2,   2,   2,   2,   2,   2,   2,   2,   2]
]