[
    [6,   6,   6,   6,   "6_11_50",   6,   6,   6,   6,   6,   6,   6,   6,   6,   6],
    [6,   1,   1,   1,   1,   1,   1,   1,   1,   1,   6,   1,   104,   1,   6],
    [6,   1,   19,   1,   1,   19,   1,   1,   1,  1,  6,   1,   1,   1,   6],
    [6,   1,   1,   1,   1,   102,   1,   1,   1,   1,   6,   1,   1,   1,   6],
    [6,   1,   1,   1,   1,   1,   1,   1,   1,   1,   6,   1,   1,   1,   6],
    [6,   1,   19,   1,   1,   19,   1,   1,   1,  1,  6,   1,   1,   1,   6],
    [6,   1,   1,   1,   1,   1,   1,   1,   1,   1,   6,   6,   6,   1,   6],
    [6,   "D",   1,   1,   1,   1,   1,   1,   1,   1,   1,   1,   1,   1,   6],
    ["6_11_150",   1,   19,   1,   1,   19,   1,   1,   1,  1,  6,   6,   6,   1,   "6_11_-150"],
    [6,   1,   1,   1,   1,   1,   1,   1,   1,   1,   6,   1,   1,   1,   6],
    [6,   1,   1,   1,   1,   1,   1,   1,   1,   1,   6,   1,   1,   1,   6],
    [6,   1,   19,   1,   1,   19,   1,   1,   1,  1,  6,   1,   1,   1,   6],
    [6,   1,   1,   1,   1,   101,   1,   1,   1,   1,   6,   1,   1,   105,   6],
    [6,   "A_9","1_5-City of Tyhr",   1,   1,   1,   1,   1,   1,   1,   6,   1,   100,   1,   6],
    [6,   6,   6,   6,   6,   6,   6,   6,   "6_11_-50",   6,   6,   6,   6,   "6_11_-50",   6]
]