[
    [10,  17,  17,  15,  16,  10,  10,  10,  10,  10,  10,  10,  10,  10,  17,  17,  16,  16,  16,  16],
    [10,  111,   "1_4-Freiyan Forest",   "A_2",16, 1,   1,   1,   10,  1,   110,   1,   1,   16,  20,   20,   -1,  20,   20,   16],
    [10,  20,   20,   20,   16,  1,   1,   1,   10,  1,   1,   1,   1,   16,  20,   20,   20,   20,   20,   16],
    [10,  20,   16,  16,  16,  1,   1,   1,   10,  1,   1,   1,   1,   16,  20,   20,   20,   20,   20,   16],
    [10,  20,   16,  1,   1,   1,   1,   10,  10,  10,  10,  10,  1,   1,   16,  16,  16,  16,  20,   16],
    [10,  20,   16,  1,   1,   100, 1,   1,   1,   1,   1,   1,   1,   1,   1,   1,   1,   1,   1,   10],
    [10,  1,   1,   1,   1,   1,   1,   1,   1,   1,   1,   1,   1,   1,   1,   1,   10,  10,  10,  10],
    [10,  1,   1,   "1_1",1,  "1_10",1, "1_1",1,  1,   10,  10,  10,  10,  10,  10,  10,  1,   1,   10],
    [10,  10,  1,   1,   1,   1,   1,   1,   1,   1,   1,   1,   10,  1,   1,   1,   10,  1,   1,   10],
    [10,  1,   1,   6,   6,   6,   6,   6,   1,   107,   1,   1,   1,   1,   1,   1,   10,  10,  1,   10],
    [10,  1,   1,   6,   1,   1,   1,   1,   1,   1,   10,  10,  10,  10,  10,  1,   10,  1,   1,   17],
    [10,  1,   1,   6,   1,   1,   1,   6,   1,   1,   1,   10,  1,   1,   10,  1,   1,   1,   1,   10],
    [10,  1,   1,   6,   1,   1,   1,   6,   1,   1,   1,   10,  1,   1,   10,  1,   10,  10,  10,  10],
    [10,  1,   1,   6,   6,   6,   6,   6,   1,   1,   1,   10,  1,   1,   10,  1,   1,   1,   1,   10],
    [10,  1,   1,   1,   1,   1,   1,   1,   1,   1,   1,   10,  1,   10,  10,  1,   10,  1,   1,   10],
    [10,  1,   1,   1,   10,  10,  10,  10,  1,   105, 1,   10,  1,   1,   1,   1,   10,  21,   1,   10],
    [10,  10,  1,   10,  10,  1,   1,   1,   1,   1,   1,   10,  1,   1,   1,   1,   10,  22,   1,   10],
    [10,  1,   1,   10,  1,   1,   1,   1,   1,   1,   1,   10,  1,   1,   1,   1,   10,  1,   1,   10],
    [10,  1,   -1,  1,   1,   1,   1,   1,   1,   1,   1,   1,   1,   1,   1,   1,   10,  "D", 1,   10],
    [10,  10,  10,  10,  10,  10,  10,  10,  10,  10,  10,  10,  10,  10,  10,  10,  10,  10,  10,  10]
]